NO ./textures/Block0.xpm
SO ./textures/Block1.xpm
WE ./textures/Block2.xpm
EA ./textures/Block3.xpm
C 20,20,30
F 30,33,32


        1111111111111111111111111
        1000000000110000000000001
        1011000001110000000000001
        1000000000x00000000000001
111111111x11000001110000000000001
1000000000110000011101111x1111111
1111011x111111011100000010001
11110110111111011101010010001
10000000x00000001101000010001
1100000111010101111011100N011
11110111 1110101 101111010001
11111111 1111111 111111111111
